NO assets/textures/ice.xpm
SO assets/textures/lava.xpm
WE assets/textures/bricks.xpm
EA assets/textures/leaves.xpm

F 101,183,65
C 123,211,234

1111111
1000X01 111
1XE00X1 1X1
1000XX1 111
1000001
100X001
1111111
