NO assets/textures/ice.xpm
SO assets/textures/lava.xpm
WE assets/textures/bricks.xpm
EA assets/textures/leaves.xpm

F 101,183,65
C 123,211,234

1111111
1000001 111
10X0001 101
100X001 111
100S001
1111111
