NO assets/textures/walls.xpm
SO assets/textures/walls1.xpm
WE assets/textures/walls2.xpm
EA assets/textures/walls4.xpm

F 101,183,65
C 123,211,234

11111111111111111111111111111111111111111111111111111111
100000000000X0000000000000000110000000000X000000000000111
10000011000000011111100000X0000000000000000000000X00000011
100000111D110000000010000000011000000000001111100010000001
10000011111100011111100X0000011000000X00001   100011110001
100X000000110001D000000000000110000X0000001   10001D110001
10000000001100011111100000X0011000000000001   100010010001
1000000000000000000000000000011000000111111111100010010001
1000001111111111111110000000011000000000000X00000000000001
100000000000000X00000000000000000000X000000000010000000001
10000X0000000000000000000X000000000000000001111110000X0001
10000000001111110000X00000000110000000000001    1000000001
10000000001    100000000000001100000000X0001    1000000001
1000X000001    1000000X000000110000000000001    100X000001
10000000001    10000000000000110X0000000000111111000000001
10000000011    110000000X00000000000000000000X000000111001
100000000D111111111111100000011000000000000000000000001001
1000000001100000000001100000000000001111110000010000001001
100000X000000000000001100000011000000D110000N0010000001001
10X000000000X000000000000000011000001111110000010011111001
1000000000000000000001110000011000000011D00000010010X00001
1000X00111111100000001110000011000000011100000011110001111
10000001111111000000000000000110000111111110000000000111
10X000000001110000X0000000000110000000110X000000111111
100000000000000X000000000000011000000011000000X0011
10000X00000000000000000000000110000X00000000000001
11111111111111111111111111111111111111111111111111
