NO assets/textures/north.xpm
SO assets/textures/west.xpm
WE assets/textures/east.xpm
EA assets/textures/bricks.xpm


F 95,95,95
C 113,211,244

        1111111111111111111111111
        1000000000110000000000001
        1011000001110000000000001
        1001000000000000000000001
111111111011000001110000000000001
100010000011000001110111100111111
1111D110111111011100000010001
11100010111101110101001000001
110000001101010111000X0010001
100X0S0100000000D100000010001
100000000X0000001101010010001
1101D1011101D10111110111100111
11111111 1111101 101111010001
11111111 1111111 111111111111