NO assets/textures/ice.xpm
SO assets/textures/lava.xpm
WE assets/textures/bricks.xpm
EA assets/textures/leaves.xpm

F 101,183,65
C 123,211,234

1111111
11111S1
1000001 111
1000001 101
1000001 111
1000001
1111111