NO assets/textures/ice.xpm
SO assets/textures/lava.xpm
WE assets/textures/bricks.xpm
EA assets/textures/leaves.xpm

F 101,183,65
C 123,211,234

1111111
1001001 111
1001001 101
1001001 111
1N0D001
1111111